NO textures/wolfenstein/eagle.xpm
EA textures/wolfenstein/purple_stone.xpm
WE textures/wolfenstein/color_stone.xpm
SO textures/wolfenstein/mossy.xpm
F 30,25,30
C 50,50,50

111111111111111111111
100000000000000000001
1000000000100000000011111111
1000001000100000000011000001
100011100001000000011000N001
10001 1000000100000011000001
1000111000111000000011111111
100000000011000000011
11111111111111111111
