NO textures/cats/perfect3.xpm
EA textures/cats/perfect4.xpm
WE textures/cats/perfectcat1.xpm
SO textures/cats/perfectcat2.xpm
F 245,245,220
C 200,173,127

111111111111111111111
100000000000000000001
1000000000100000000011111111
1000001000100000000011000001
1000111000010000000000000001
10001 100000010N000011000001
1000111000111000000011111111
10000000001 100000011
11111111111 11111111
