EA textures/cats/perfect4.xpm
NO textures/cats/perfect3.xpm
SO textures/cats/perfectcat2.xpm
WE textures/cats/perfectcat1.xpm
C 200,173,127
F 245,245,220

111111111111111111111
100000000000000000001
1000000000100000000011111111
1000001000100000000011000001
100011100001000000000000N001
10001 1000000100000011000001
1000111000111000000011111111
10000000001 10000001
11111111111 11111111
