NO ./path_to_the_north_texture
SO ./path_to_the_south_texture
WE ./path_to_the_west_texture
EA ./path_to_the_east_texture
F 220,100,0
C 225,30,255

111111111111111111111
100000000000000000001
100000000010000000001
100000100010000000001
1000000000N1000000001
100000000000010000001
100000000010000000001
100000000000000000001
111111111111111111111
